11111111111111111111111111111111
1.............................U1
1..............................1
1..................1...........1
1..............................1
111............................1
1.....1........................1
1P....1.......................11
11...11111SSSSSSSSSSSSSSSSSSSSS1
1......111.....................1
1.......111.O..................1
1........11....................1
1........111...........1.......1
1.........11...........1.......1
1.........111111111111111......1
1.........111........S.........1
1...........1........S........11
1.............................11
1..........111.....M.........111
1..........111.................1
1.......C..111...SSSSSSSSSSSSSS1
1..........1111.........M......1
1..........1111.........M.C....1
1SSSSSSSSSS111111111111111111111